111111111111
100000000001
A01111010111
101100000111
101101011001
100001000001
110111111101
B01011001001
100000010011
111111111111